1111111111111
100P00C000111
1000001111001
100000000E001
100C000000001
1000C00000001
1000000000001
1111111111111
